X X X X X X X X X X X X X X X X X X X X X X X X X 
X W W W W W W W W W W W W W W W W W W W W W W W X 
X W W W W W W W W W W W W W W W W W W W W W W W X 
X W W W W W W W W W W W W W W W W W W W W W W W X 
X W W W W W W W W W W W W W W W W W W W W W W W X 
X W W W W W W W W W W W W W W W W W W W W W W W X 
X W W W W W W W W W W W W W W W W W W W W W W W X 
X W W W W W W W W W W W W W W W W W W W W W W W X 
X W S S S W W W W W W W W W W W W W W W W W W W X
X W W W W W W W W W W W W W W W W W W W W W W W X 
X W W W W W W W W W W W W W W W W W W W W W W W X 
X W W W W W W W W W W W W W W W W W W W W W W W X 
X W W W W W W W W W W W W W W W W W W W W W W W X 
X W W W W W W W W W W W W W W W W W W W W W W W X 
X W W W W W W W W W W W W W W W W W W W W W W W X 
X W W W W W W W W W W W W W W W W W W W W W W W X 
X W W W W W W W W W W W W W W W W W W W W W W W X 
X W W W W W W W W W W W W W W W W W W W W W W W X 
X W W W W W W W W W W W W W W W W W W W W W W W X 
X W W W W W W W W W W W W W W W W W W W W W W W X 
X W W W W W W W W W W W W W W W W W W W W W W W X 
X W W W W W W W W W W W W W W W W W W W W W W W X 
X W W W W W W W W W W W W W W W W W W W W W W W X 
X W W W W W W W W W W W W W W W W W W W W W W W X 
X W W W W W W W W W W W W W W W W W W W W W W W X 
X W W W W W W W W W W W W W W W W W W W W W W W X 
X W W W W W W W W W W W W W W W W W W W W W W W X 
X W W W W W W W W W W W W W W W W W W W W W W W X 
X W W W W W W W W W W W W W W W W W W W W W W W X 
X W W W W W W W W W W W W W W W W W W W W W W W X 
X W W W W W W W W W W W W W W W W W W W W W W W X 
X W W W W W W W W W W W W W W W W W W W W W W W X 
X W W W W W W W W W W W W W W W W W W W W W W W X 
X W W W W W W W W W W W W W W W W W W W W W W W X 
X W W W W W W W W W W W W W W W W W W W W W W W X 
X W W W W W W W W W W W W W W W W W W W W W W W X 
X W W W W W W W W W W W W W W W W W W W W W W W X 
X W W W W W W W W W W W W W W W W W W W W W W W X 
X W W W W W W W W W W W W W W W W W W W W W W W X 
X W W W W W W W W W W W W W W W W W W W W W W W X 
X W W W W W W W W W W W W W W W W W W W W W W W X 
X W W W W W W W W W W W W W W W W W W W W W W W X 
X W W W W W W W W W W W W W W W W W W W W W W W X 
X W W W W W W W W W W W W W W W W W W W W W W W X 
X W W W W W W W W W W W W W W W W W W W W W W W X 
X W W W W W W W W W W W W W W W W W W W W W W W X 
X W W W W W W W W W W W W W W W W W W W W W W W X 
X W W W W W W W W W W W W W W W W W W W W W W W X 
X W W W W W W W W W W W W W W W W W W W W W W W X 
X W W W W W W W W W W W W W W W W W W W W W W W X 
X W W W W W W W W W W W W W W W W W W W W W W W X 
X W W W W W W W W W W W W W W W W W W W W W W S X 
X W W W W W W W W W W W W W W W W W W W W W W S X 
X W W W W W W W W W W W W W W W W W W W W W W S X 
X W W W W W W W W W W W W W W W W W W W W W W S X 
X W W W W W W W W W W W W W W W W W W W W W W S X 
X W W W W W W W W W W W W W W W W W W W W W W S X 
X W W W W W W W W W W W W W W W W W W W W W W S X 
X W W W W W W W W W W W W W W W W W W W W W W S X 
X W W W W W W W W W W W W W W W W W W W W W W S X 
X W W W W W W W W W W W W W W W W W W W W W W S X 
X W W W W W W W W W W W W W W W W W W W W W W S X 
X W W W W W W W W W W W W W W W W W W W W W W S X 
X W W W W W W W W W W W W W W W W W W W W W W S X 
X W W W W W W W W W W W W W W W W W W W W W W S X 
X W W W W W W W W W W W W W W W W W W W W W W S X 
X W W W W W W W W W W W W W W W W W W W W W W S X 
X W W W W W W W W W W W W W W W W W W W W W W S X 
X W W W W W W W W W W W W W W W W W W W W W W S X 
X W W W W W W W W W W W W W W W W W W W W W W S X 
X W W W W W W W W W W W W W W W W W W W W W W S X 
X W W W W W W W W W W W W W W W W W W W W W W S X 
X W W W W W W W W W W W W W W W W W W W W W W S X 
X W W W W W W W W W W W W W W W W W W W W W W S X 
X W W W W W W W W W W W W W W W W W W W W W W S X 
X W W W W W W W W W W W W W W W W W W W W W W S X 
X W W W W W W W W W W W W W W W W W W W W W W S X 
X W W W W W W W W W W W W W W W W W W W W W W S X 
X W W W W W W W W W W W W W W W W W W W W W W S X 
X W W W W W W W W W W W W W W W W W W W W W W S X 
X W W W W W W W W W W W W W W W W W W W W W W S X 
X W W W W W W W W W W W W W W W W W W W W W W S X 
X W W W W W W W W W W W W W W W W W W W W W W S X 
X W W W W W W W W W W W W W W W W W W W W W W S X 
X W W W W W W W W W W W W W W W W W W W W W W S X 
X W W W W W W W W W W W W W W W W W W W W W W S X 
X W W W W W W W W W W W W W W W W W W W W W W S X 
X W W W W W W W W W W W W W W W W W W W W W W S X 
X W W W W W W W W W W W W W W W W W W W W W W S X 
X W W W W W W W W W W W W W W W W W W W W W W S X 
X W W W W W W W W W W W W W W W W W W W W W W S X 
X W W W W W W W W W W W W W W W W W W W W W W S X 
X W W W W W W W W W W W W W W W W W W W W W W S X 
X W W W W W W W W W W W W W W W W W W W W W W S X 
X W W W W W W W W W W W W W W W W W W W W W W S X 
X W W W W W W W W W W W W W W W W W W W W W W S X 
X W W W W W W W W W W W W W W W W W W W W W W S X 
X W W W W W W W W W W W W W W W W W W W W W W S X 
X W W W W W W W W W W W W W W W W W W W W W W S X 
X W W W W W W W W W W W W W W W W W W W W W W S X 
X W W W W W W W W W W W W W W W W W W W W W W S X 
X W W W W W W W W W W W W W W W W W W W W W W S X 
X W W W W W W W W W W W W W W W W W W W W W W S X 
X W W W W W W W W W W W W W W W W W W W W W W S X 
X W W W W W W W W W W W W W W W W W W W W W W S X 
X W W W W W W W W W W W W W W W W W W W W W W S X 
X W W W W W W W W W W W W W W W W W W W W W W S X 
X W W W W W W W W W W W W W W W W W W W W W W S X 
X W W W W W W W W W W W W W W W W W W W W W W S X 
X W W W W W W W W W W W W W W W W W W W W W W S X 
X W W W W W W W W W W W W W W W W W W W W W W S X 
X W W W W W W W W W W W W W W W W W W W W W W S X 
X W W W W W W W W W W W W W W W W W W W W W W S X 
X W W W W W W W W W W W W W W W W W W W W W W S X 
X W W W W W W W W W W W W W W W W W W W W W W S X 
X W W W W W W W W W W W W W W W W W W W W W W S X 
X W W W W W W W W W W W W W W W W W W W W W W S X 
X W W W W W W W W W W W W W W W W W W W W W W S X 
X W W W W W W W W W W W W W W W W W W W W W W S X 
X W W W W W W W W W W W W W W W W W W W W W W S X 
X W W W W W W W W W W W W W W W W W W W W W W S X 
X W W W W W W W W W W W W W W W W W W W W W W S X 
X W W W W W W W W W W W W W W W W W W W W W W S X 
X W W W W W W W W W W W W W W W W W W W W W W S X 
X W W W W W W W W W W W W W W W W W W W W W W S X 
X W W W W W W W W W W W W W W W W W W W W W W S X 
X W W W W W W W W W W W W W W W W W W W W W W S X 
X W W W W W W W W W W W W W W W W W W W W W W S X 
X W W W W W W W W W W W W W W W W W W W W W W S X 
X W W W W W W W W W W W W W W W W W W W W W W S X 
X W W W W W W W W W W W W W W W W W W W W W W S X 
X W W W W W W W W W W W W W W W W W W W W W W S X 
X W W W W W W W W W W W W W W W W W W W W W W S X 
X W W W W W W W W W W W W W W W W W W W W W W S X 
X W W W W W W W W W W W W W W W W W W W W W W S X 
X W W W W W W W W W W W W W W W W W W W W W W S X 
X W W W W W W W W W W W W W W W W W W W W W W S X 
X W W W W W W W W W W W W W W W W W W W W W W S X 
X W W W W W W W W W W W W W W W W W W W W W W S X 
X W W W W W W W W W W W W W W W W W W W W W W S X 
X W W W W W W W W W W W W W W W W W W W W W W S X 
X W W W W W W W W W W W W W W W W W W W W W W S X 
X W W W W W W W W W W W W W W W W W W W W W W S X 
X W W W W W W W W W W W W W W W W W W W W W W S X 
X W W W W W W W W W W W W W W W W W W W W W W S X 
X W W W W W W W W W W W W W W W W W W W W W W S X 
X W W W W W W W W W W W W W W W W W W W W W W S X 
X W W W W W W W W W W W W W W W W W W W W W W S X 
X W W W W W W W W W W W W W W W W W W W W W W S X 
X W W W W W W W W W W W W W W W W W W W W W W S X 
X W W W W W W W W W W W W W W W W W W W W W W S X 
X W W W W W W W W W W W W W W W W W W W W W W S X 
X W W W W W W W W W W W W W W W W W W W W W W S X 
X W W W W W W W W W W W W W W W W W W W W W W S X 
X W W W W W W W W W W W W W W W W W W W W W W S X 
X W W W W W W W W W W W W W W W W W W W W W W S X 
X W W W W W W W W W W W W W W W W W W W W W W S X 
X W W W W W W W W W W W W W W W W W W W W W W S X 
X W W W W W W W W W W W W W W W W W W W W W W S X 
X W W W W W W W W W W W W W W W W W W W W W W S X 
X W W W W W W W W W W W W W W W W W W W W W W S X 
X W W W W W W W W W W W W W W W W W W W W W W S X 
X W W W W W W W W W W W W W W W W W W W W W W S X 
X W W W W W W W W W W W W W W W W W W W W W W S X 
X W W W W W W W W W W W W W W W W W W W W W W S X 
X W W W W W W W W W W W W W W W W W W W W W W S X 
X W W W W W W W W W W W W W W W W W W W W W W S X 
X W W W W W W W W W W W W W W W W W W W W W W S X 
X W W W W W W W W W W W W W W W W W W W W W W S X 
X W W W W W W W W W W W W W W W W W W W W W W S X 
X W W W W W W W W W W W W W W W W W W W W W W S X 
X W W W W W W W W W W W W W W W W W W W W W W S X 
X W W W W W W W W W W W W W W W W W W W W W W S X 
X W W W W W W W W W W W W W W W W W W W W W W S X 
X W W W W W W W W W W W W W W W W W W W W W W S X 
X W W W W W W W W W W W W W W W W W W W W W W S X 
X W W W W W W W W W W W W W W W W W W W W W W S X 
X W W W W W W W W W W W W W W W W W W W W W W S X 
X W W W W W W W W W W W W W W W W W W W W W W S X 
X W W W W W W W W W W W W W W W W W W W W W W S X 
X W W W W W W W W W W W W W W W W W W W W W W S X 
X W W W W W W W W W W W W W W W W W W W W W W S X 
X W W W W W W W W W W W W W W W W W W W W W W S X 
X W W W W W W W W W W W W W W W W W W W W W W S X 
X W W W W W W W W W W W W W W W W W W W W W W S X 
X W W W W W W W W W W W W W W W W W W W W W W S X 
X W W W W W W W W W W W W W W W W W W W W W W S X 
X W W W W W W W W W W W W W W W W W W W W W W S X 
X W W W W W W W W W W W W W W W W W W W W W W S X 
X W W W W W W W W W W W W W W W W W W W W W W S X 
X W W W W W W W W W W W W W W W W W W W W W W S X 
X W W W W W W W W W W W W W W W W W W W W W W S X 
X W W W W W W W W W W W W W W W W W W W W W W S X 
X W W W W W W W W W W W W W W W W W W W W W W S X 
X W W W W W W W W W W W W W W W W W W W W W W S X 
X W W W W W W W W W W W W W W W W W W W W W W S X 
X W W W W W W W W W W W W W W W W W W W W W W S X 
X W W W W W W W W W W W W W W W W W W W W W W S X 
X W W W W W W W W W W W W W W W W W W W W W W S X 
X W W W W W W W W W W W W W W W W W W W W W W S X 
X W W W W W W W W W W W W W W W W W W W W W W S X 
X W W W W W W W W W W W W W W W W W W W W W W S X 
X W W W W W W W W W W W W W W W W W W W W W W S X 
X W W W W W W W W W W W W W W W W W W W W W W S X 
X W W W W W W W W W W W W W W W W W W W W W W S X 
X W W W W W W W W W W W W W W W W W W W W W W S X 
X W W W W W W W W W W W W W W W W W W W W W W S X 
X W W W W W W W W W W W W W W W W W W W W W W S X 
X W W W W W W W W W W W W W W W W W W W W W W S X 
X W W W W W W W W W W W W W W W W W W W W W W S X 
X W W W W W W W W W W W W W W W W W W W W W W S X 
X W W W W W W W W W W W W W W W W W W W W W W S X 
X W W W W W W W W W W W W W W W W W W W W W W S X 
X W W W W W W W W W W W W W W W W W W W W W W S X 
X W W W W W W W W W W W W W W W W W W W W W W S X 
X W W W W W W W W W W W W W W W W W W W W W W S X 
X W W W W W W W W W W W W W W W W W W W W W W S X 
X W W W W W W W W W W W W W W W W W W W W W W S X 
X W W W W W W W W W W W W W W W W W W W W W W S X 
X W W W W W W W W W W W W W W W W W W W W W W S X 
X W W W W W W W W W W W W W W W W W W W W W W S X 
X W W W W W W W W W W W W W W W W W W W W W W S X 
X W W W W W W W W W W W W W W W W W W W W W W S X 
X W W W W W W W W W W W W W W W W W W W W W W S X 
X W W W W W W W W W W W W W W W W W W W W W W S X 
X W W W W W W W W W W W W W W W W W W W W W W S X 
X W W W W W W W W W W W W W W W W W W W W W W S X 
X W W W W W W W W W W W W W W W W W W W W W W S X 
X W W W W W W W W W W W W W W W W W W W W W W S X 
X W W W W W W W W W W W W W W W W W W W W W W S X 
X W W W W W W W W W W W W W W W W W W W W W W S X 
X W W W W W W W W W W W W W W W W W W W W W W S X 
X W W W W W W W W W W W W W W W W W W W W W W S X 
X W W W W W W W W W W W W W W W W W W W W W W S X 
X W W W W W W W W W W W W W W W W W W W W W W S X 
X W W W W W W W W W W W W W W W W W W W W W W S X 
X W W W W W W W W W W W W W W W W W W W W W W S X 
X W W W W W W W W W W W W W W W W W W W W W W S X 
X W W W W W W W W W W W W W W W W W W W W W W S X 
X W W W W W W W W W W W W W W W W W W W W W W S X 
X W W W W W W W W W W W W W W W W W W W W W W S X 
X W W W W W W W W W W W W W W W W W W W W W W S X 
X W W W W W W W W W W W W W W W W W W W W W W S X 
X W W W W W W W W W W W W W W W W W W W W W W S X 
X W W W W W W W W W W W W W W W W W W W W W W S X 
X W W W W W W W W W W W W W W W W W W W W W W S X 
X W W W W W W W W W W W W W W W W W W W W W W S X 
X W W W W W W W W W W W W W W W W W W W W W W S X 
X W W W W W W W W W W W W W W W W W W W W W W S X 
X W W W W W W W W W W W W W W W W W W W W W W S X 
X W W W W W W W W W W W W W W W W W W W W W W S X 
X W W W W W W W W W W W W W W W W W W W W W W S X 
X W W W W W W W W W W W W W W W W W W W W W W S X 
X W W W W W W W W W W W W W W W W W W W W W W S X 
X W W W W W W W W W W W W W W W W W W W W W W S X 
X W W W W W W W W W W W W W W W W W W W W W W S X 
X W W W W W W W W W W W W W W W W W W W W W W S X 
X W W W W W W W W W W W W W W W W W W W W W W S X 
X W W W W W W W W W W W W W W W W W W W W W W S X 
X W W W W W W W W W W W W W W W W W W W W W W S X 
X W W W W W W W W W W W W W W W W W W W W W W S X 
X W W W W W W W W W W W W W W W W W W W W W W S X 
X W W W W W W W W W W W W W W W W W W W W W W S X 
X W W W W W W W W W W W W W W W W W W W W W W S X 
X W W W W W W W W W W W W W W W W W W W W W W S X 
X W W W W W W W W W W W W W W W W W W W W W W S X 
X W W W W W W W W W W W W W W W W W W W W W W S X 
X W W W W W W W W W W W W W W W W W W W W W W S X 
X W W W W W W W W W W W W W W W W W W W W W W S X 
X W W W W W W W W W W W W W W W W W W W W W W S X 
X W W W W W W W W W W W W W W W W W W W W W W S X 
X W W W W W W W W W W W W W W W W W W W W W W S X 
X W W W W W W W W W W W W W W W W W W W W W W S X 
X W W W W W W W W W W W W W W W W W W W W W W S X 
X W W W W W W W W W W W W W W W W W W W W W W S X 
X W W W W W W W W W W W W W W W W W W W W W W S X 
X W W W W W W W W W W W W W W W W W W W W W W S X 
X W W W W W W W W W W W W W W W W W W W W W W S X 
X W W W W W W W W W W W W W W W W W W W W W W S X 
X W W W W W W W W W W W W W W W W W W W W W W S X 
X W W W W W W W W W W W W W W W W W W W W W W S X 
X W W W W W W W W W W W W W W W W W W W W W W S X 
X W W W W W W W W W W W W W W W W W W W W W W S X 
X W W W W W W W W W W W W W W W W W W W W W W S X 
X W W W W W W W W W W W W W W W W W W W W W W S X 
X W W W W W W W W W W W W W W W W W W W W W W S X 
X W W W W W W W W W W W W W W W W W W W W W W S X 
X W W W W W W W W W W W W W W W W W W W W W W S X 
X W W W W W W W W W W W W W W W W W W W W W W S X 
X W W W W W W W W W W W W W W W W W W W W W W S X 
X W W W W W W W W W W W W W W W W W W W W W W S X 
X W W W W W W W W W W W W W W W W W W W W W W S X 
X W W W W W W W W W W W W W W W W W W W W W W S X 
X W W W W W W W W W W W W W W W W W W W W W W S X 
X W W W W W W W W W W W W W W W W W W W W W W S X 
X W W W W W W W W W W W W W W W W W W W W W W S X 
X W W W W W W W W W W W W W W W W W W W W W W S X 
X W W W W W W W W W W W W W W W W W W W W W W S X 
X W W W W W W W W W W W W W W W W W W W W W W S X 
X W W W W W W W W W W W W W W W W W W W W W W S X 
X W W W W W W W W W W W W W W W W W W W W W W S X 
X W W W W W W W W W W W W W W W W W W W W W W S X 
X W W W W W W W W W W W W W W W W W W W W W W S X 
X W W W W W W W W W W W W W W W W W W W W W W S X 
X W W W W W W W W W W W W W W W W W W W W W W S X 
X W W W W W W W W W W W W W W W W W W W W W W S X 
X W W W W W W W W W W W W W W W W W W W W W W S X 
X W W W W W W W W W W W W W W W W W W W W W W S X 
X W W W W W W W W W W W W W W W W W W W W W W S X 
X W W W W W W W W W W W W W W W W W W W W W W S X 
X W W W W W W W W W W W W W W W W W W W W W W S X 
X W W W W W W W W W W W W W W W W W W W W W W S X 
X W W W W W W W W W W W W W W W W W W W W W W S X 
X W W W W W W W W W W W W W W W W W W W W W W S X 
X W W W W W W W W W W W W W W W W W W W W W W S X 
X W W W W W W W W W W W W W W W W W W W W W W S X 
X W W W W W W W W W W W W W W W W W W W W W W S X 
X W W W W W W W W W W W W W W W W W W W W W W S X 
X W W W W W W W W W W W W W W W W W W W W W W S X 
X W W W W W W W W W W W W W W W W W W W W W W S X 
X W W W W W W W W W W W W W W W W W W W W W W S X 
X W W W W W W W W W W W W W W W W W W W W W W S X 
X W W W W W W W W W W W W W W W W W W W W W W S X 
X W W W W W W W W W W W W W W W W W W W W W W S X 
X W W W W W W W W W W W W W W W W W W W W W W S X 
X W W W W W W W W W W W W W W W W W W W W W W S X 
X W W W W W W W W W W W W W W W W W W W W W W S X 
X W W W W W W W W W W W W W W W W W W W W W W S X 
X W W W W W W W W W W W W W W W W W W W W W W S X 
X W W W W W W W W W W W W W W W W W W W W W W S X 
X W W W W W W W W W W W W W W W W W W W W W W S X 
X W W W W W W W W W W W W W W W W W W W W W W S X 
X W W W W W W W W W W W W W W W W W W W W W W S X 
X W W W W W W W W W W W W W W W W W W W W W W S X 
X W W W W W W W W W W W W W W W W W W W W W W S X 
X W W W W W W W W W W W W W W W W W W W W W W S X 
X W W W W W W W W W W W W W W W W W W W W W W S X 
X W W W W W W W W W W W W W W W W W W W W W W S X 
X W W W W W W W W W W W W W W W W W W W W W W S X 
X W W W W W W W W W W W W W W W W W W W W W W S X 
X W W W W W W W W W W W W W W W W W W W W W W S X 
X W W W W W W W W W W W W W W W W W W W W W W S X 
X W W W W W W W W W W W W W W W W W W W W W W S X 
X W W W W W W W W W W W W W W W W W W W W W W S X 
X W W W W W W W W W W W W W W W W W W W W W W S X 
X W W W W W W W W W W W W W W W W W W W W W W S X 
X W W W W W W W W W W W W W W W W W W W W W W S X 
X W W W W W W W W W W W W W W W W W W W W W W S X 
X W W W W W W W W W W W W W W W W W W W W W W S X 
X W W W W W W W W W W W W W W W W W W W W W W S X 
X W W W W W W W W W W W W W W W W W W W W W W S X 
X W W W W W W W W W W W W W W W W W W W W W W S X 
X W W W W W W W W W W W W W W W W W W W W W W S X 
X W W W W W W W W W W W W W W W W W W W W W W S X 
X W W W W W W W W W W W W W W W W W W W W W W S X 
X W W W W W W W W W W W W W W W W W W W W W W S X 
X W W W W W W W W W W W W W W W W W W W W W W S X 
X W W W W W W W W W W W W W W W W W W W W W W S X 
X W W W W W W W W W W W W W W W W W W W W W W S X 
X W W W W W W W W W W W W W W W W W W W W W W S X 
X W W W W W W W W W W W W W W W W W W W W W W S X 
X W W W W W W W W W W W W W W W W W W W W W W S X 
X W W W W W W W W W W W W W W W W W W W W W W S X 
X W W W W W W W W W W W W W W W W W W W W W W S X 
X W W W W W W W W W W W W W W W W W W W W W W S X 
X W W W W W W W W W W W W W W W W W W W W W W S X 
X W W W W W W W W W W W W W W W W W W W W W W S X 
X W W W W W W W W W W W W W W W W W W W W W W S X 
X W W W W W W W W W W W W W W W W W W W W W W S X 
X W W W W W W W W W W W W W W W W W W W W W W S X 
X W W W W W W W W W W W W W W W W W W W W W W S X 
X W W W W W W W W W W W W W W W W W W W W W W S X 
X W W W W W W W W W W W W W W W W W W W W W W S X 
X W W W W W W W W W W W W W W W W W W W W W W S X 
X W W W W W W W W W W W W W W W W W W W W W W S X 
X W W W W W W W W W W W W W W W W W W W W W W S X 
X W W W W W W W W W W W W W W W W W W W W W W S X 
X W W W W W W W W W W W W W W W W W W W W W W S X 
X W W W W W W W W W W W W W W W W W W W W W W S X 
X W W W W W W W W W W W W W W W W W W W W W W S X 
X W W W W W W W W W W W W W W W W W W W W W W S X 
X W W W W W W W W W W W W W W W W W W W W W W S X 
X W W W W W W W W W W W W W W W W W W W W W W S X 
X W W W W W W W W W W W W W W W W W W W W W W S X 
X W W W W W W W W W W W W W W W W W W W W W W S X 
X W W W W W W W W W W W W W W W W W W W W W W S X 
X W W W W W W W W W W W W W W W W W W W W W W S X 
X W W W W W W W W W W W W W W W W W W W W W W S X 
X W W W W W W W W W W W W W W W W W W W W W W S X 
X W W W W W W W W W W W W W W W W W W W W W W S X 
X W W W W W W W W W W W W W W W W W W W W W W S X 
X W W W W W W W W W W W W W W W W W W W W W W S X 
X W W W W W W W W W W W W W W W W W W W W W W S X 
X W W W W W W W W W W W W W W W W W W W W W W S X 
X W W W W W W W W W W W W W W W W W W W W W W S X 
X W W W W W W W W W W W W W W W W W W W W W W S X 
X W W W W W W W W W W W W W W W W W W W W W W S X 
X W W W W W W W W W W W W W W W W W W W W W W S X 
X W W W W W W W W W W W W W W W W W W W W W W S X 
X X X X X X X X X X X X X X X X X X X X X X X X X 
