X X X X X X X X X X X X X X X X X X X X X X X X X 
X S W W W W W W W W W W W W W W W W W W W W W W X 
X W W W W W W W W W W W W W W W W W W W W W W W X 
X W W W W W W W W W W W W W W W W W W W W W W W X 
X S W W W W W W W W W W W W W W W W W W W W W W X 
X W W W W W W W W W W W W W W W W W W W W W W S X 
X W W W W W W W W W W W W W W W W W W W W W W W X 
X W W W W W W W W W W W W W W W W W W W W W W W X 
X W W W W W W W W W W W W W W W W W W W W W W W X 
X W W W W W W W W W W W W W W W W W W W W W W W X 
X W W W W W W W W W W W W W W W W W W W W W W W X 
X W W W W W W W W W W W W W W W W W W W W W W W X 
X W W W W W W W W W W W W W W W W W W W W W W S X 
X W W W W W W W W W W W W W W W W W W W W W W W X 
X W W W W W W W W W W W W W W W W W W W W W W W X 
X W W W W W W W W W W W W W W W W W W W W W W S X 
X S W W W W W W W W W W W W W W W W W W W W W W X 
X W W W W W W W W W W W W W W W W W W W W W W S X 
X W W W W W W W W W W W W W W W W W W W W W W W X 
X W W W W W W W W W W W W W W W W W W W W W W W X 
X W W W W W W W W W W W W W W W W W W W W W W W X 
X W W W W W W W W W W W W W W W W W W W W W W W X 
X W W W W W W W W W W W W W W W W W W W W W W W X 
X W W W W W W W W W W W W W W W W W W W W W W W X 
X W W W W W W W W W W W W W W W W W W W W W W W X 
X W W W W W W W W W W W W W W W W W W W W W W W X 
X W W W W W W W W W W W W W W W W W W W W W W W X 
X W W W W W W W W W W W W W W W W W W W W W W W X 
X W W W W W W W W W W W W W W W W W W W W W W W X 
X W W W W W W W W W W W W W W W W W W W W W W S X 
X W W W W W W W W W W W W W W W W W W W W W W W X 
X S W W W W W W W W W W W W W W W W W W W W W W X 
X W W W W W W W W W W W W W W W W W W W W W W S X 
X W W W W W W W W W W W W W W W W W W W W W W W X 
X W W W W W W W W W W W W W W W W W W W W W W W X 
X S W W W W W W W W W W W W W W W W W W W W W W X 
X W W W W W W W W W W W W W W W W W W W W W W S X 
X W W W W W W W W W W W W W W W W W W W W W W S X 
X W W W W W W W W W W W W W W W W W W W W W W W X 
X W W W W W W W W W W W W W W W W W W W W W W S X 
X W W W W W W W W W W W W W W W W W W W W W W W X 
X W W W W W W W W W W W W W W W W W W W W W W W X 
X W W W W W W W W W W W W W W W W W W W W W W S X 
X S W W W W W W W W W W W W W W W W W W W W W S X 
X W W W W W W W W W W W W W W W W W W W W W W W X 
X W W W W W W W W W W W W W W W W W W W W W W S X 
X W W W W W W W W W W W W W W W W W W W W W W W X 
X W W W W W W W W W W W W W W W W W W W W W W W X 
X S W W W W W W W W W W W W W W W W W W W W W W X 
X X X X X X X X X X X X X X X X X X X X X X X X X 
