X X X X X X X X X X X X X X X X X X X X X X X X X 
X RS W W W W W W W W W W W W W W W W W W W W W W X 
X W W W W W W W W W W W W W W W W W W W W W W W X 
X W W W W W W W W W W W W W W W W W W W W W W W X 
X W W W W W W W W W W W W W W W W W W W W W W W X 
X RS W W W W W W W W W W W W W W W W W W W W W S X 
X RS W W W W W W W W W W W W W W W W W W W W W W X 
X W W W W W W W W W W W W W W W W W W W W W W W X 
X W W W W W W W W W W W W W W W W W W W W W W W X 
X W W W W W W W W W W W W W W W W W W W W W W W X 
X W W W W W W W W W W W W W W W W W W W W W W W X 
X W W W W W W W W W W W W W W W W W W W W W W W X 
X W W W W W W W W W W W W W W W W W W W W W W W X 
X W W W W W W W W W W W W W W W W W W W W W W W X 
X W W W W W W W W W W W W W W W W W W W W W W W X 
X W W W W W W W W W W W W W W W W W W W W W W W X 
X RS W W W W W W W W W W W W W W W W W W W W W W X 
X W W W W W W W W W W W W W W W W W W W W W W W X 
X RS W W W W W W W W W W W W W W W W W W W W W W X 
X W W W W W W W W W W W W W W W W W W W W W W W X 
X W W W W W W W W W W W W W W W W W W W W W W W X 
X RS W W W W W W W W W W W W W W W W W W W W W S X 
X W W W W W W W W W W W W W W W W W W W W W W W X 
X W W W W W W W W W W W W W W W W W W W W W W W X 
X W W W W W W W W W W W W W W W W W W W W W W S X 
X W W W W W W W W W W W W W W W W W W W W W W W X 
X W W W W W W W W W W W W W W W W W W W W W W W X 
X W W W W W W W W W W W W W W W W W W W W W W W X 
X W W W W W W W W W W W W W W W W W W W W W W W X 
X W W W W W W W W W W W W W W W W W W W W W W S X 
X W W W W W W W W W W W W W W W W W W W W W W W X 
X W W W W W W W W W W W W W W W W W W W W W W W X 
X W W W W W W W W W W W W W W W W W W W W W W W X 
X W W W W W W W W W W W W W W W W W W W W W W W X 
X RS W W W W W W W W W W W W W W W W W W W W W S X 
X W W W W W W W W W W W W W W W W W W W W W W S X 
X W W W W W W W W W W W W W W W W W W W W W W W X 
X W W W W W W W W W W W W W W W W W W W W W W W X 
X W W W W W W W W W W W W W W W W W W W W W W W X 
X W W W W W W W W W W W W W W W W W W W W W W W X 
X RS W W W W W W W W W W W W W W W W W W W W W W X 
X W W W W W W W W W W W W W W W W W W W W W W W X 
X W W W W W W W W W W W W W W W W W W W W W W W X 
X W W W W W W W W W W W W W W W W W W W W W W W X 
X W W W W W W W W W W W W W W W W W W W W W W W X 
X W W W W W W W W W W W W W W W W W W W W W W W X 
X W W W W W W W W W W W W W W W W W W W W W W W X 
X RS W W W W W W W W W W W W W W W W W W W W W W X 
X RS W W W W W W W W W W W W W W W W W W W W W W X 
X X X X X X X X X X X X X X X X X X X X X X X X X 
